---X-------X-------T-------X-------E-------X-------
-X-------X-------X-------X-------X-------X---------
-------X-------X-------X-------X-------X-----------
-X-------X-------X-------X-------X-------X---------
-------X-------T-------X-------X-------X-----------
-X-------X-------X-------X-------O-------X---------
E-----X-------X-------X-------X-------X------------
-X-------X-------X-------T-------X-------X---------
-------X-------X-------X-------X-------X-----------
-X-------T-------X-------E-------X-------X---------
-------X-------X-------X-------X-------X-----------
-X-------X-------X-------X-------X-------T---------
-------X-------X-------T-------X-------X-----------
-X-------X-------X-------X-------X-------X---------
E-----X-------X-------X-------X-------X------------
-X-------X-------T-------X-------O-------X---------
-------X-------X-------X-------X-------X-----------
-X-------X-------X-------E-------X-------X---------
-------T-------X-------X-------X-------X-----------
-X-------X-------X-------X-------X-------X---------
-------X-------X-------T-------X-------X-----------
-X-------X-------X-------X-------X-------T---------
E-----X-------X-------X-------X-------X------------
-X-------T-------X-------X-------X-------X---------
-------X-------X-------X-------E-------X-----------
-X-------X-------X-------X-------X-------X---------
-------X-------X-------T-------X-------X-----------
-X-------X-------X-------X-------O-------X---------
-------X-------T-------X-------X-------X-----------
-X-------X-------X-------X-------X-------X---------
E-----X-------X-------X-------X-------X------------
-X-------X-------X-------T-------X-------X---------
-------X-------X-------X-------E-------X-----------
-X-------T-------X-------X-------X-------X---------
-------X-------X-------X-------X-------T-----------
-X-------X-------X-------X-------X-------X---------
-------X-------T-------X-------X-------X-----------
-X-------X-------X-------X-------X-------X---------
E-----X-------X-------X-------X-------X------------
-X-------X-------X-------T-------O-------X---------
-------X-------X-------X-------X-------X-----------
-X-------X-------X-------E-------X-------X---------
-------T-------X-------X-------X-------X-----------
-X-------X-------X-------X-------X-------T---------
-------X-------X-------T-------X-------X-----------
-X-------X-------X-------X-------X-------X---------
E-----X-------X-------X-------X-------X------------
-X-------T-------X-------X-------X-------X---------
-------X-------X-------X-------E-------X-----------
-X-------X-------X-------X-------X-------X---------
-------X-------X-------T-------X-------X-----------
-X-------X-------X-------X-------O-------X---------
-------X-------T-------X-------X-------X-----------
-X-------X-------X-------X-------X-------X---------
E-----X-------X-------X-------X-------X------------
