----X-------T-------X-------E-------X-------T-------X-------
--X-------X-------X-------X-------X-------X-------X---------
--------X-------X-------X-------X-------X-------X-----------
--X-------X-------X-------X-------X-------X-------X---------
E-------X-------T-------X-------X-------T-------X-----------
--X-------X-------X-------X-------X-------X-------X---------
--------X-------X-------X-------O-------X-------X-----------
--X-------X-------X-------X-------X-------X-------X---------
--------X-------T-------X-------E-------X-------T-------X---
--X-------X-------X-------X-------X-------X-------X---------
E-------X-------X-------X-------X-------X-------X-----------
--X-------X-------X-------X-------X-------X-------X---------
--------X-------X-------T-------X-------X-------X-----------
--X-------X-------X-------X-------X-------X-------X---------
--------X-------X-------X-------X-------X-------T-------X---
--X-------X-------X-------X-------O-------X-------X---------
E-------X-------T-------X-------X-------X-------X-----------
--X-------X-------X-------X-------X-------X-------X---------
--------X-------X-------X-------E-------X-------X-----------
--X-------X-------X-------T-------X-------X-------X---------
--------X-------X-------X-------X-------X-------T-------X---
--X-------X-------X-------X-------X-------X-------X---------
--------X-------T-------X-------X-------X-------X-----------
--X-------X-------X-------X-------X-------X-------X---------
E-------X-------X-------X-------X-------X-------X-----------
--X-------X-------X-------T-------X-------X-------X---------
--------X-------X-------X-------O-------X-------T-------X---
--X-------X-------X-------X-------X-------X-------X---------
--------X-------T-------X-------E-------X-------X-----------
--X-------X-------X-------X-------X-------X-------X---------
--------X-------X-------X-------X-------X-------T-------X---
--X-------X-------X-------X-------X-------X-------X---------
E-------X-------T-------X-------X-------X-------X-----------
--X-------X-------X-------X-------X-------X-------X---------
--------X-------X-------X-------X-------X-------X-----------
--X-------X-------X-------T-------X-------X-------X---------
--------X-------X-------X-------E-------X-------T-------X---
--X-------X-------X-------X-------X-------X-------X---------
E-------X-------T-------X-------X-------O-------X-----------
--X-------X-------X-------X-------X-------X-------X---------
