--X------E--------X------T--------X-------O-------X-----
X---------X-------------X-------X-----------X-----------
------T--------X--------------X--------E--------X-------
--X--------------X----X-----------X-------------X-------
---------X----------E---------X----------X--------------
X------X---------T--------X-----------X---------X-------
----------X-----------X--------X----T-----------X-------
--X-----------X-----------X-----------X---------X-------
------X-----E-----X-----------X-----------X-------------
X-----------X-----------T---------X-----------X---------
----------X-----------X-----------X-----O---------------
--X-----------X-----------X-----------X---------X-------
------X-----------X-----T-----X-----------X-------------
X-----------X-----------X-----------X-----------X-------
----------X-----------X--------E--X-----------X---------
--X-----------T-----------X-----------X---------X-------
------X-----------X-----------X-----------X-------------
X-----------X-----------X-----------X-----------X-------
----------X-----------X-----------X-----------X---------
--X-----------X------T----X-----------X---------X-------
------X-----------X-----------X-----E-----X-------------
X-----------X-----------X-----------X-----------X-------
----------X-----------X-----------X-----------X---------
--X-----T-----X-----------X-----------X---------X-------
------X-----------X-----------X-----------X-------------
X-----------X-----------X-----------X-----------X-O-----
----------X-----------X--------T--X-----------X---------
--X-----------X-----------X-----------X---------X-------
------X-----------X-----------X-----E-----X-------------
X-----------X-----------X-----------X-----------X-------
----------X-----------X-----------X-----------X---------
--X-----------X-----------X----T------X---------X-------
------X-----------X-----------X-----------X-------------
X--------T--X-----------X-----------X-----------X-------
----------X-----------X-----------X-----------X---------
--X-----------X-----------X-----------X-----E---X-------
------X-----------X-----------X-----------X-------------
X-----------X-----------X-----------X-----------X-------
----------X------T----X-----------X-----------X---------
--X-----------X-----------X-----------X---------X-------
------X-----------X-----------X-----------X-------------
X-----------X-----------X-----------X-----------X-------
----------X-----------X-----------X-----------X---------
--X-----------X--------T--X-----------X---------X----O--
------X-----------X-----------X-----E-----X-------------
X-----------X-----------X-----------X-----------X-------
----------X-----------X-----------X-----------X---------
--X-----T-----X-----------X-----------X---------X-------
------X-----------X-----------X-----------X-------------
X-----------X-----------X-----------X-----------X-------
