----X------CT-------X-------E-------X------CT-------X-------
--X-------XC------X-------X-------X-------XC------X---------
--------X-------X-------X-------X-------X-------X-----------
--X-------X-------X-------X-------X-----C-X-------X---------
E-------X-------TC------X-------X-------TC------X-----------
--X-------X-----C-X-------X----CCCX-------X-------X---------
--------X-------X-------X-------OC------X-------X-----------
--X-------X-----C-X-------X-------X-------X-----C-X---------
--------X-------TC------X-------E-------X-------TC------X---
--X-------X-------X-------X-------X-------X-------X---------
E-------X-------X-------X-------X-------X-------X-----------
--X-------X-------X-----C-X-------X-------X-------X---------
--------X-------X-------TC------X-------X-------X-----------
--X-------X-------X-------X-------X-------X-----C-X---------
--------X-------X-------X-------XCCC----X-------TC------X---
--X-------X-----C-X-------X------CO-------X-------X---------
E-------X-------TC------X-------XCCC----X-------X-----------
--X-------X-------X-------X-------X-------X-------X---------
--------X-------X-------X-C-----E-------X-------X-----------
--X-------X-------X------CT-------X-------X-----C-X---------
--------X-------X-------X-------X-------X-------TC------X---
--X-------X-----C-X-------X-------X-------X-------X---------
--------X-------TC------X-------X-------X-------X-----------
--X-------X-------X-------X-------X-------X-------X---------
E-------X-------X-------X-C-----X-------X-------X-----------
--X-------X-------X------CT----CCCX-------X-------X---------
--------X-------X-------X-------OC------X-------T-------X---
--X-------X-------X-------X-------X-------X-----C-X---------
--------X-------T-------X-------E-------X-------X-----------
--X-------X-----C-X-------X-------X-------X-----C-X---------
--------X-------X-------X-------X-------X-------T-------X---
--X-------X-----C-X-------X-------X-------X-------X---------
E-------X-------T-------X-------X-------X-------X-----------
--X-------X-------X-------X-------X-------X-------X---------
--------X-------X-------X-C-----X-------X-------X-----------
--X-------X-------X------CT-------X-------X-----C-X---------
--------X-------X-------X-------E-------X-------TC------X---
--X-------X-----C-X-------X-------X----CCCX-------X---------
E-------X-------TC------X-------X-------OC------X-----------
--X-------X-------X-------X-------X-------X-------X---------
