---X-------X------CT-------X-------E-------X-------
-X-------X-------XC------X-------X-------X---------
-------X-------X-------X-------X-------X-----------
-X-------X-----C-X-------X-------X-------X---------
-------X-------TC------X-------X-------X-----------
-X-------X-------X-------X-------O-------X---------
E-----X-------X-------X--C----X-------X------------
-X-------X-------X------CT-------X-------X---------
-------X-C-----X-------X-------X-------X-----------
-X------CT-------X-------E-------X-------X---------
-------X-------X-------X-------X-------X-C---------
-X-------X-------X-----C-X-------X------CT---------
-------X-------X-------TC------X-------X-----------
-X-------X-------X-------X-------X-------X---------
E-----X-------X--C----X-------X-------X------------
-X-------X------CT-------X-------O-------X---------
-------X-------X-------X-------X-------X-----------
-X-----C-X-------X-------E-------X-------X---------
-------TC------X-------X-------X-------X-----------
-X-------X-------X-----C-X-------X-------X---------
-------X-------X-------TC------X-------X-C---------
-X-------X-------X-------X-------X------CT---------
E-----X--C----X-------X-------X-------X------------
-X------CT-------X-------X-------X-------X---------
-------X-------X-------X-------E-------X-----------
-X-------X-------X-----C-X-------X-------X---------
-------X-------X-------TC------X-------X-----------
-X-------X-----C-X-------X-------O-------X---------
-------X-------TC------X-------X-------X-----------
-X-------X-------X-------X-------X-------X---------
E-----X-------X-------X--C----X-------X------------
-X-------X-------X------CT-------X-------X---------
-------X-C-----X-------X-------E-------X-----------
-X------CT-------X-------X-------X-----C-X---------
-------X-------X-------X-------X-------TC----------
-X-------X-----C-X-------X-------X-------X---------
-------X-------TC------X-------X-------X-----------
-X-------X-------X-------X-------X-------X---------
E-----X-------X-------X--C----X-------X------------
-X-------X-------X------CT-------O-------X---------
-------X-------X-------X-------X-------X-----------
-X-----C-X-------X-------E-------X-------X---------
-------TC------X-------X-------X-------X-C---------
-X-------X-------X-----C-X-------X------CT---------
-------X-------X-------TC------X-------X-----------
-X-------X-------X-------X-------X-------X---------
E-----X--C----X-------X-------X-------X------------
-X------CT-------X-------X-------X-------X---------
-------X-------X-------X-------E-------X-----------
-X-------X-------X-----C-X-------X-------X---------
-------X-------X-------TC------X-------X-----------
-X-------X-----C-X-------X-------O-------X---------
-------X-------TC------X-------X-------X-----------
-X-------X-------X-------X-------X-------X---------
E-----X-------X-------X-------X-------X------------
