--X------E--------X-----CT--------X-------OC------X-----
X---------X-------------XC------X----------CX-----------
---C--T--C-----X--------------X--------E--------X-------
--X--------------X----X-----------X-------------X-------
------C--X------CC--E---------X----------X--------------
X------X---------T--------X----------CX---------X-------
----------X-----------X--------X----TC----------X-------
--X-----------X-----------X-----------X---------X-------
------X-----E-----X-----------X-----------X-------------
X-----------X----------CT---------X------C----X---------
----------X-----------XC----------X-----O---------------
--X-----------X-----------X-----------X---------X-------
------X-----------X-----TC----X-----------X-------------
X-----------X-----------X-----------X-----------X-------
----------X--C--------X--------E--X-----------X---------
--X-----------T-----------X-----------X---------X-------
------X------C----X-----------X-----------X-------------
X-----------X-----------X-----------X-----------X-------
----------X----------CX-----------X-----------X---------
--X-----------X------TC---X-----------X---------X-------
------X-----------X-----------X-----E-----X-------------
X-----------X-----------X-----------X-----------X-------
----------X-----------X-----------X-----------X---------
--X----CTC----X-----------X-----------X---------X-------
------X-----------X-----------X-----------X------C------
X-----------X-----------X------C----X-----------X-O-----
----------X-----------X--------T--X-----------X--C------
--X-----------X-----------X----C------X---------X-------
------X-----------X-----------X-----E-----X-------------
X-----------X-----------X-----------X-----------X-------
----------X-----------X-----------X-----------X---------
--X-----------X-----------X---CT------X---------X-------
------X-----------X-----------XC----------X-------------
X--------TC-X-----------X-----------X-----------X-------
---------CX-----------X-----------X-----------X---------
--X-----------X-----------X-----------X-----E---X-------
------X-----------X-----------X-----------X-------------
X-----------X----C------X-----------X-----------X-------
----------X------T----X-----------X-----------X---------
--X-----------X--C--------X-----------X---------X-------
------X-----------X-----------X-----------X-------------
X-----------X-----------X-----------X-----------X-------
----------X-----------XC----------X-----------X---------
--X-----------X-------CT--X-----------X---------X----O--
------X-----------X-----------X-----E-----X-------------
X-----------X-----------X-----------X-----------X-------
----------X-----------X-----------X-----------X---------
--X----CTC----X-----------X-----------X---------X-------
------X-----------X-----------X-----------X-------------
X-----------X-----------X-----------X-----------X-------
